Nombre	Nombre Usuario	Estudiante/Maestro
Albertina Medcalf	amedcalf	maestro,estudiante
Apryl Sison	asison	maestro
Benito Creasy	bcreasy	estudiante
Bertie Wurtz	bwurtz	maestro
Boris Mccreary	bmccreary	maestro,estudiante
Bret Wadlow	bwadlow	estudiante
Darcy Garwood	dgarwood	estudiante
Demetra Nickerson	dnickerson	maestro,estudiante
Denis Spies	dspies	estudiante
Dora Stimage	dstimage	maestro
Efrain Skaggs	eskaggs	estudiante
Emely Silveria	esilveria	estudiante
Ferdinand Lolley	flolley	maestro,estudiante
Fermin Schaar	fschaar	maestro,estudiante
Florinda Shim	fshim	maestro,estudiante
Georgeanna Jauregui	gjauregui	estudiante
Gladys Wardlaw	gwardlaw	estudiante
Glayds Cobb	gcobb	estudiante
Grazyna Slavens	gslavens	maestro
Indira Thronson	ithronson	estudiante
Jacalyn Maudlin	jmaudlin	estudiante
Jama Parris	jparris	estudiante
Janelle Amen	jamen	maestro,estudiante
Jenise Nath	jnath	maestro,estudiante
Jennefer Bevington	jbevington	estudiante
Kacey Holden	kholden	estudiante
Kaleigh Leffler	kleffler	estudiante
Kallie Oslund	koslund	estudiante
Kayleen Resto	kresto	estudiante
Kip Orloff	korloff	estudiante
Kyong Mejorado	kmejorado	estudiante
Laurinda Hanger	lhanger	maestro
Leana Mcrae	lmcrae	estudiante
Lindsey Graziano	lgraziano	maestro
Lisandra Matherne	lmatherne	estudiante
Lorrie Clover	lclover	estudiante
Margret Siller	msiller	maestro
Marilyn Lint	mlint	maestro,estudiante
Marya Wilbert	mwilbert	estudiante
Particia Keogh	pkeogh	estudiante
Pasty Wyse	pwyse	estudiante
Pei Marlowe	pmarlowe	estudiante
Porsche Beckmann	pbeckmann	maestro
Rhett Tassin	rtassin	maestro,estudiante
Shaunta Baver	sbaver	maestro
Thomasine Volker	tvolker	maestro,estudiante
Tuan Vinci	tvinci	estudiante
Vannesa Frierson	vfrierson	estudiante
Virgen Chowdhury	vchowdhury	maestro
Yee Barone	ybarone	estudiante
